   0	1 0 0	1 0 0 0
	owo
     0	1	1 0 0	1 0	1
	owo
     0	1	1 0	1	1 0 0
	owo
     0	1	1 0	1	1 0 0
	owo
     0	1	1 0	1	1	1	1
	owo
     0 0	1 0 0 0 0 0
	owo
     0	1 0	1 0	1	1	1
	owo
     0	1	1 0	1	1	1	1
	owo
     0	1	1	1 0 0	1 0
	owo
     0	1	1 0	1	1 0 0
	owo
     0	1	1 0 0	1 0 0
	owo
     0 0	1 0 0 0 0	1
	owo
  owo
